111111111111111111111
100202020202020202001
101210101010101012101
122304030204030403221
101010101010101010101
120202020302020202021
101010101410101010101
120202034443020202021
101010101410101010101
120202020302020202021
101010101010101010101
120404020202020202021
101010101010101010101
122304020202020403221
101210101010101012101
000200020202020202001
111111111111111111111
