111111111111111111111
100200202000200000001
101210101010101010101
102200000300302202001
101010101010101010101
102220042202002002001
101310101010101010101
100022002000200300001
101310101010121010101
100000002420022200001
101210101010101010101
100200420022200420001
141010101010101010101
122200000220000000001
101210101410101010141
100200000000000004001
111111111111111111111
