111111111111111111111
100020000000000000001
101012101012101012101
120000022002000002001
101010101010101010101
120020220020000000201
101010121210121210121
102200000000020200001
101210101210101010121
100000002000020200001
101010101010101010101
100002000000002000001
101010101010101010101
100000002000020200001
101210101210101010121
102200000000020200001
111111111111111111111
