111111111111111111111
100200000200000000021
101010101010121210101
120020220002000002001
101012101010101010101
102220000000022200001
121010101012101012101
102002000200000000021
101210101010101010101
100000022020200020201
101010101010101010101
100000000020000000201
101010101010101010101
100000022020200020201
101210101010101010101
102002000200000000021
111111111111111111111
