111111111111111111111
100000022000222000221
101010101210101012101
100002202022020220201
101010101210101012101
120000222020020020221
101012101012101210101
102222000002000200001
101210101010101010101
120022002202000202201
101010101210101012101
100200020000202000021
101010101210101012101
120022002202000202201
101210101010101010101
102222000002000200001
111111111111111111111
