111111111111111111111
100200003200040002201
101010101210101012101
102300020022000220021
101010101010101010101
124300022044000020221
101010101012101210101
122002000000030000401
101010101010101010101
122302002002020300201
101010101012101210101
100400002000030000201
101010101012101210101
123002002002020300201
101010101010101010101
122004002220000004001
111111111111111111111
