111111111111111111111
100000000000020200001
101010101010101010101
100200000000202020001
101010101010101010101
100002222002000002001
121010101010101010101
120020020022000002201
101010121010121210101
100000000220002000221
101010101010101010101
100000000200200020021
101010101010101010101
100000000220002000221
101010121010121210101
120020020022000002201
111111111111111111111
