111111111111111111111
100000000000000000001
101012121010101010121
120020222022020220221
101212101210101012101
122020200022000220001
101010121210121012121
100200000000020000001
101210101210101012101
102002200002020200001
101210121010121010121
100002000002000200001
101210121010121010121
102002200002020200001
101210101210101012101
100200000000020000001
111111111111111111111
