111111111111111111111
100200000200020002001
101010101010121010101
122020222022020220221
101010101210121012101
122020220000020000021
101010101010101010101
102202000202000202001
101210101010101010101
100000022020202020221
101210101210101012101
100000020020202020021
101210101210101012101
100000022020202020221
101210101010101010101
102202000202000202001
111111111111111111111
