111111111111111111111
100020000002002002001
101012101010101010101
102200000200202020021
101010101010101010101
100002200200200020021
101210121010101010101
100000222020020200201
101010101012101012101
120022000000000000001
101210101010101010101
102000000000000000001
101210101010101010101
120022000000000000001
101010101012101012101
100000222020020200201
111111111111111111111
